WWWWWWWWWWWWWWWWW
W---------------W
W---S-------S---W
W-P--------S----W
W---------------W
W---S-------G---W
WWWWWWWWWWWWWWWWW