WWWWWWWWWWWW
W----------W
W---S------W
W-P--------W
W---G------W
WWWWWWWWWWWW